111111111111111
1000000000000P1
111111110000001
111111100C00001
100000001111111
1E0000000000001
111111111111111