11111111111111111111
1000000000000000E001
11111111000000001001
11111110C00111111111
10000110111111111111
100000P0000111111111
11111111111111111111